NO ./path_to_the_north_texture
SO ./path_to_the_south_texture 
WE ./path_to_the_west_texture

C 225,30,240
F  00251,   0000220,  00000000255
EA       ./path_to_the_east_texture    dfgd




        1111111111111111111111111                                                                                                               
        1000000000110000000000001              1
        1011000001110000000000001
        1001000000000000000000001
1111111110110S00001110000000000001
100000000011000001110111111111111
111111111111111111111111111111111
111111111111111111111111111111111
11110111111111011100000010001
11110111111111011101010010001
11000000110101011100000010001
10000000000000000000000010001
10000000000000001101010010001
1100000111010101 111011000011
11110111 1110101 101111010001
11111111 1111111 111111111111






















